"filename", "language", "Java", "comment", "blank", "total"
"c:\Users\cgsan\git\csc217-L-231-26\PackScheduler\src\edu\ncsu\csc216\pack_scheduler\catalog\CourseCatalog.java", "Java", -72, -60, -25, -157
"c:\Users\cgsan\git\csc217-L-231-26\PackScheduler\src\edu\ncsu\csc216\pack_scheduler\course\Activity.java", "Java", -169, -89, -27, -285
"c:\Users\cgsan\git\csc217-L-231-26\PackScheduler\src\edu\ncsu\csc216\pack_scheduler\course\Conflict.java", "Java", -4, -14, -4, -22
"c:\Users\cgsan\git\csc217-L-231-26\PackScheduler\src\edu\ncsu\csc216\pack_scheduler\course\ConflictException.java", "Java", -10, -17, -7, -34
"c:\Users\cgsan\git\csc217-L-231-26\PackScheduler\src\edu\ncsu\csc216\pack_scheduler\course\Course.java", "Java", -231, -131, -41, -403
"c:\Users\cgsan\git\csc217-L-231-26\PackScheduler\src\edu\ncsu\csc216\pack_scheduler\course\roll\CourseRoll.java", "Java", -118, -73, -14, -205
"c:\Users\cgsan\git\csc217-L-231-26\PackScheduler\src\edu\ncsu\csc216\pack_scheduler\course\validator\CourseNameValidator.java", "Java", -148, -140, -20, -308
"c:\Users\cgsan\git\csc217-L-231-26\PackScheduler\src\edu\ncsu\csc216\pack_scheduler\course\validator\CourseNameValidatorFSM.java", "Java", -102, -35, -29, -166
"c:\Users\cgsan\git\csc217-L-231-26\PackScheduler\src\edu\ncsu\csc216\pack_scheduler\course\validator\InvalidTransitionException.java", "Java", -10, -19, -5, -34
"c:\Users\cgsan\git\csc217-L-231-26\PackScheduler\src\edu\ncsu\csc216\pack_scheduler\directory\FacultyDirectory.java", "Java", -91, -65, -21, -177
"c:\Users\cgsan\git\csc217-L-231-26\PackScheduler\src\edu\ncsu\csc216\pack_scheduler\directory\StudentDirectory.java", "Java", -96, -66, -19, -181
"c:\Users\cgsan\git\csc217-L-231-26\PackScheduler\src\edu\ncsu\csc216\pack_scheduler\io\CourseRecordIO.java", "Java", -86, -31, -24, -141
"c:\Users\cgsan\git\csc217-L-231-26\PackScheduler\src\edu\ncsu\csc216\pack_scheduler\io\FacultyRecordIO.java", "Java", -56, -28, -10, -94
"c:\Users\cgsan\git\csc217-L-231-26\PackScheduler\src\edu\ncsu\csc216\pack_scheduler\io\StudentRecordIO.java", "Java", -63, -28, -11, -102
"c:\Users\cgsan\git\csc217-L-231-26\PackScheduler\src\edu\ncsu\csc216\pack_scheduler\manager\RegistrationManager.java", "Java", -193, -110, -33, -336
"c:\Users\cgsan\git\csc217-L-231-26\PackScheduler\src\edu\ncsu\csc216\pack_scheduler\ui\CourseCatalogPanel.java", "Java", -463, -101, -51, -615
"c:\Users\cgsan\git\csc217-L-231-26\PackScheduler\src\edu\ncsu\csc216\pack_scheduler\ui\FacultyDirectoryPanel.java", "Java", -285, -84, -41, -410
"c:\Users\cgsan\git\csc217-L-231-26\PackScheduler\src\edu\ncsu\csc216\pack_scheduler\ui\InstructorAssignmentPanel.java", "Java", -380, -161, -66, -607
"c:\Users\cgsan\git\csc217-L-231-26\PackScheduler\src\edu\ncsu\csc216\pack_scheduler\ui\PackSchedulerGUI.java", "Java", -290, -99, -54, -443
"c:\Users\cgsan\git\csc217-L-231-26\PackScheduler\src\edu\ncsu\csc216\pack_scheduler\ui\StudentDirectoryPanel.java", "Java", -278, -85, -43, -406
"c:\Users\cgsan\git\csc217-L-231-26\PackScheduler\src\edu\ncsu\csc216\pack_scheduler\ui\StudentRegistrationPanel.java", "Java", -326, -108, -50, -484
"c:\Users\cgsan\git\csc217-L-231-26\PackScheduler\src\edu\ncsu\csc216\pack_scheduler\user\Faculty.java", "Java", -66, -56, -14, -136
"c:\Users\cgsan\git\csc217-L-231-26\PackScheduler\src\edu\ncsu\csc216\pack_scheduler\user\Student.java", "Java", -250, -113, -37, -400
"c:\Users\cgsan\git\csc217-L-231-26\PackScheduler\src\edu\ncsu\csc216\pack_scheduler\user\User.java", "Java", -117, -64, -17, -198
"c:\Users\cgsan\git\csc217-L-231-26\PackScheduler\src\edu\ncsu\csc216\pack_scheduler\user\schedule\FacultySchedule.java", "Java", -55, -31, -10, -96
"c:\Users\cgsan\git\csc217-L-231-26\PackScheduler\src\edu\ncsu\csc216\pack_scheduler\user\schedule\Schedule.java", "Java", -81, -61, -12, -154
"c:\Users\cgsan\git\csc217-L-231-26\PackScheduler\src\edu\ncsu\csc216\pack_scheduler\util\ArrayList.java", "Java", -96, -53, -14, -163
"c:\Users\cgsan\git\csc217-L-231-26\PackScheduler\src\edu\ncsu\csc216\pack_scheduler\util\ArrayQueue.java", "Java", -39, -41, -12, -92
"c:\Users\cgsan\git\csc217-L-231-26\PackScheduler\src\edu\ncsu\csc216\pack_scheduler\util\ArrayStack.java", "Java", -39, -42, -10, -91
"c:\Users\cgsan\git\csc217-L-231-26\PackScheduler\src\edu\ncsu\csc216\pack_scheduler\util\LinkedAbstractList.java", "Java", -173, -79, -19, -271
"c:\Users\cgsan\git\csc217-L-231-26\PackScheduler\src\edu\ncsu\csc216\pack_scheduler\util\LinkedList.java", "Java", -159, -122, -31, -312
"c:\Users\cgsan\git\csc217-L-231-26\PackScheduler\src\edu\ncsu\csc216\pack_scheduler\util\LinkedListRecursive.java", "Java", -177, -119, -24, -320
"c:\Users\cgsan\git\csc217-L-231-26\PackScheduler\src\edu\ncsu\csc216\pack_scheduler\util\LinkedQueue.java", "Java", -31, -37, -11, -79
"c:\Users\cgsan\git\csc217-L-231-26\PackScheduler\src\edu\ncsu\csc216\pack_scheduler\util\LinkedStack.java", "Java", -31, -38, -10, -79
"c:\Users\cgsan\git\csc217-L-231-26\PackScheduler\src\edu\ncsu\csc216\pack_scheduler\util\Queue.java", "Java", -8, -34, -8, -50
"c:\Users\cgsan\git\csc217-L-231-26\PackScheduler\src\edu\ncsu\csc216\pack_scheduler\util\Stack.java", "Java", -8, -34, -7, -49
"c:\Users\cgsan\git\csc217-L-231-26\PackScheduler\test\edu\ncsu\csc216\pack_scheduler\catalog\CourseCatalogTest.java", "Java", 79, 40, 20, 139
"c:\Users\cgsan\git\csc217-L-231-26\PackScheduler\test\edu\ncsu\csc216\pack_scheduler\course\ActivityTest.java", "Java", 27, 13, 14, 54
"c:\Users\cgsan\git\csc217-L-231-26\PackScheduler\test\edu\ncsu\csc216\pack_scheduler\course\ConflictExceptionTest.java", "Java", 15, 13, 6, 34
"c:\Users\cgsan\git\csc217-L-231-26\PackScheduler\test\edu\ncsu\csc216\pack_scheduler\course\CourseTest.java", "Java", 354, 112, 58, 524
"c:\Users\cgsan\git\csc217-L-231-26\PackScheduler\test\edu\ncsu\csc216\pack_scheduler\course\roll\CourseRollTest.java", "Java", 86, 22, 11, 119
"c:\Users\cgsan\git\csc217-L-231-26\PackScheduler\test\edu\ncsu\csc216\pack_scheduler\course\validator\CourseNameValidatorFSMTest.java", "Java", 138, 34, 25, 197
"c:\Users\cgsan\git\csc217-L-231-26\PackScheduler\test\edu\ncsu\csc216\pack_scheduler\course\validator\CourseNameValidatorTest.java", "Java", 138, 31, 44, 213
"c:\Users\cgsan\git\csc217-L-231-26\PackScheduler\test\edu\ncsu\csc216\pack_scheduler\course\validator\InvalidTransitionExceptionTest.java", "Java", 15, 13, 6, 34
"c:\Users\cgsan\git\csc217-L-231-26\PackScheduler\test\edu\ncsu\csc216\pack_scheduler\directory\FacultyDirectoryTest.java", "Java", 106, 43, 21, 170
"c:\Users\cgsan\git\csc217-L-231-26\PackScheduler\test\edu\ncsu\csc216\pack_scheduler\directory\StudentDirectoryTest.java", "Java", 109, 50, 27, 186
"c:\Users\cgsan\git\csc217-L-231-26\PackScheduler\test\edu\ncsu\csc216\pack_scheduler\io\CourseRecordIOTest.java", "Java", 91, 39, 19, 149
"c:\Users\cgsan\git\csc217-L-231-26\PackScheduler\test\edu\ncsu\csc216\pack_scheduler\io\FacultyRecordIOTest.java", "Java", 66, 19, 12, 97
"c:\Users\cgsan\git\csc217-L-231-26\PackScheduler\test\edu\ncsu\csc216\pack_scheduler\io\StudentRecordIOTest.java", "Java", 103, 36, 22, 161
"c:\Users\cgsan\git\csc217-L-231-26\PackScheduler\test\edu\ncsu\csc216\pack_scheduler\manager\RegistrationManagerTest.java", "Java", 343, 60, 64, 467
"c:\Users\cgsan\git\csc217-L-231-26\PackScheduler\test\edu\ncsu\csc216\pack_scheduler\user\FacultyTest.java", "Java", 91, 35, 17, 143
"c:\Users\cgsan\git\csc217-L-231-26\PackScheduler\test\edu\ncsu\csc216\pack_scheduler\user\StudentTest.java", "Java", 187, 49, 31, 267
"c:\Users\cgsan\git\csc217-L-231-26\PackScheduler\test\edu\ncsu\csc216\pack_scheduler\user\schedule\FacultyScheduleTest.java", "Java", 134, 46, 31, 211
"c:\Users\cgsan\git\csc217-L-231-26\PackScheduler\test\edu\ncsu\csc216\pack_scheduler\user\schedule\ScheduleTest.java", "Java", 95, 32, 14, 141
"c:\Users\cgsan\git\csc217-L-231-26\PackScheduler\test\edu\ncsu\csc216\pack_scheduler\users\StudentTest.java", "Java", 40, 22, 12, 74
"c:\Users\cgsan\git\csc217-L-231-26\PackScheduler\test\edu\ncsu\csc216\pack_scheduler\util\ArrayListTest.java", "Java", 46, 20, 10, 76
"c:\Users\cgsan\git\csc217-L-231-26\PackScheduler\test\edu\ncsu\csc216\pack_scheduler\util\ArrayQueueTest.java", "Java", 76, 23, 11, 110
"c:\Users\cgsan\git\csc217-L-231-26\PackScheduler\test\edu\ncsu\csc216\pack_scheduler\util\ArrayStackTest.java", "Java", 76, 26, 11, 113
"c:\Users\cgsan\git\csc217-L-231-26\PackScheduler\test\edu\ncsu\csc216\pack_scheduler\util\LinkedAbstractListTest.java", "Java", 63, 23, 13, 99
"c:\Users\cgsan\git\csc217-L-231-26\PackScheduler\test\edu\ncsu\csc216\pack_scheduler\util\LinkedListRecursiveTest.java", "Java", 66, 21, 13, 100
"c:\Users\cgsan\git\csc217-L-231-26\PackScheduler\test\edu\ncsu\csc216\pack_scheduler\util\LinkedListTest.java", "Java", 78, 20, 13, 111
"c:\Users\cgsan\git\csc217-L-231-26\PackScheduler\test\edu\ncsu\csc216\pack_scheduler\util\LinkedQueueTest.java", "Java", 76, 23, 11, 110
"c:\Users\cgsan\git\csc217-L-231-26\PackScheduler\test\edu\ncsu\csc216\pack_scheduler\util\LinkedStackTest.java", "Java", 76, 23, 11, 110
"c:\Users\cgsan\git\csc217-L-231-26\PackScheduler\test\edu\ncsu\csc217\collections\list\SortedListTest.java", "Java", 165, 74, 62, 301
"Total", "-", -1862, -1506, -222, -3590