"filename", "language", "Java", "comment", "blank", "total"
"c:\Users\cgsan\git\csc217-L-231-26\PackScheduler\test\edu\ncsu\csc216\pack_scheduler\catalog\CourseCatalogTest.java", "Java", 79, 40, 20, 139
"c:\Users\cgsan\git\csc217-L-231-26\PackScheduler\test\edu\ncsu\csc216\pack_scheduler\course\ActivityTest.java", "Java", 27, 13, 14, 54
"c:\Users\cgsan\git\csc217-L-231-26\PackScheduler\test\edu\ncsu\csc216\pack_scheduler\course\ConflictExceptionTest.java", "Java", 15, 13, 6, 34
"c:\Users\cgsan\git\csc217-L-231-26\PackScheduler\test\edu\ncsu\csc216\pack_scheduler\course\CourseTest.java", "Java", 354, 112, 58, 524
"c:\Users\cgsan\git\csc217-L-231-26\PackScheduler\test\edu\ncsu\csc216\pack_scheduler\course\roll\CourseRollTest.java", "Java", 86, 22, 11, 119
"c:\Users\cgsan\git\csc217-L-231-26\PackScheduler\test\edu\ncsu\csc216\pack_scheduler\course\validator\CourseNameValidatorFSMTest.java", "Java", 138, 34, 25, 197
"c:\Users\cgsan\git\csc217-L-231-26\PackScheduler\test\edu\ncsu\csc216\pack_scheduler\course\validator\CourseNameValidatorTest.java", "Java", 138, 31, 44, 213
"c:\Users\cgsan\git\csc217-L-231-26\PackScheduler\test\edu\ncsu\csc216\pack_scheduler\course\validator\InvalidTransitionExceptionTest.java", "Java", 15, 13, 6, 34
"c:\Users\cgsan\git\csc217-L-231-26\PackScheduler\test\edu\ncsu\csc216\pack_scheduler\directory\FacultyDirectoryTest.java", "Java", 106, 43, 21, 170
"c:\Users\cgsan\git\csc217-L-231-26\PackScheduler\test\edu\ncsu\csc216\pack_scheduler\directory\StudentDirectoryTest.java", "Java", 109, 50, 27, 186
"c:\Users\cgsan\git\csc217-L-231-26\PackScheduler\test\edu\ncsu\csc216\pack_scheduler\io\CourseRecordIOTest.java", "Java", 91, 39, 19, 149
"c:\Users\cgsan\git\csc217-L-231-26\PackScheduler\test\edu\ncsu\csc216\pack_scheduler\io\FacultyRecordIOTest.java", "Java", 66, 19, 12, 97
"c:\Users\cgsan\git\csc217-L-231-26\PackScheduler\test\edu\ncsu\csc216\pack_scheduler\io\StudentRecordIOTest.java", "Java", 103, 36, 22, 161
"c:\Users\cgsan\git\csc217-L-231-26\PackScheduler\test\edu\ncsu\csc216\pack_scheduler\manager\RegistrationManagerTest.java", "Java", 343, 60, 64, 467
"c:\Users\cgsan\git\csc217-L-231-26\PackScheduler\test\edu\ncsu\csc216\pack_scheduler\user\FacultyTest.java", "Java", 91, 35, 17, 143
"c:\Users\cgsan\git\csc217-L-231-26\PackScheduler\test\edu\ncsu\csc216\pack_scheduler\user\StudentTest.java", "Java", 187, 49, 31, 267
"c:\Users\cgsan\git\csc217-L-231-26\PackScheduler\test\edu\ncsu\csc216\pack_scheduler\user\schedule\FacultyScheduleTest.java", "Java", 134, 46, 31, 211
"c:\Users\cgsan\git\csc217-L-231-26\PackScheduler\test\edu\ncsu\csc216\pack_scheduler\user\schedule\ScheduleTest.java", "Java", 95, 32, 14, 141
"c:\Users\cgsan\git\csc217-L-231-26\PackScheduler\test\edu\ncsu\csc216\pack_scheduler\users\StudentTest.java", "Java", 40, 22, 12, 74
"c:\Users\cgsan\git\csc217-L-231-26\PackScheduler\test\edu\ncsu\csc216\pack_scheduler\util\ArrayListTest.java", "Java", 46, 20, 10, 76
"c:\Users\cgsan\git\csc217-L-231-26\PackScheduler\test\edu\ncsu\csc216\pack_scheduler\util\ArrayQueueTest.java", "Java", 76, 23, 11, 110
"c:\Users\cgsan\git\csc217-L-231-26\PackScheduler\test\edu\ncsu\csc216\pack_scheduler\util\ArrayStackTest.java", "Java", 76, 26, 11, 113
"c:\Users\cgsan\git\csc217-L-231-26\PackScheduler\test\edu\ncsu\csc216\pack_scheduler\util\LinkedAbstractListTest.java", "Java", 63, 23, 13, 99
"c:\Users\cgsan\git\csc217-L-231-26\PackScheduler\test\edu\ncsu\csc216\pack_scheduler\util\LinkedListRecursiveTest.java", "Java", 66, 21, 13, 100
"c:\Users\cgsan\git\csc217-L-231-26\PackScheduler\test\edu\ncsu\csc216\pack_scheduler\util\LinkedListTest.java", "Java", 78, 20, 13, 111
"c:\Users\cgsan\git\csc217-L-231-26\PackScheduler\test\edu\ncsu\csc216\pack_scheduler\util\LinkedQueueTest.java", "Java", 76, 23, 11, 110
"c:\Users\cgsan\git\csc217-L-231-26\PackScheduler\test\edu\ncsu\csc216\pack_scheduler\util\LinkedStackTest.java", "Java", 76, 23, 11, 110
"c:\Users\cgsan\git\csc217-L-231-26\PackScheduler\test\edu\ncsu\csc217\collections\list\SortedListTest.java", "Java", 165, 74, 62, 301
"Total", "-", 2939, 962, 609, 4510